#######
S..#..#
#.#.#.#
#...#.E
#.###.#
#.....#
#######
