#################
S..#...##..#....E
#.#.#.#..##.#.###
#.#.#.#.##......#
#...#...#.#####.#
###.#.###..#....#
#...#..#.#.#.####
#.###..#.##....##
#.....#.##.##.###
####.####.#.#...#
#.#.....#...#..##
#.#.##.##.###.###
#...#...#.......#
###.###.#.#######
#.....#.........#
#################
